. 0A W 88 X B0
. 0 W 1 X 1
..........
..........
....WWWW..
.........W
...WWWWW..
..........
........X.
..........
....@.....
..........