..........
..........
....WWWW..
.........W
...WWWWW..
..........
..........
..........
....@.....
..........