. 0A W 88 X B0
. 0 W 1 X 1
X 3
X.........
..&.......
....WWWW..
.........W
...WWWWW..
......&...
........X.
..........
.X..@.....
..........